 ##########################
   #         ####     #     #
#  #         #    #   #  #  #
#  ###########  ###      #  #
#                 #  ##  #* #
#############################